9 9 9 9 9 9 9 9 9 9 9 9 9 9 9 9 9 9 9 9 9 9 9 9 9 9 9 9 9 9 9 9 9 9 9 9 9 9 9 9 9 9 9 9 9 9 9 9 9 9 
9 9 9 9 9 9 9 9 9 9 9 9 9 9 9 9 9 9 9 9 12 12 12 12 12 12 12 9 9 9 9 9 9 9 9 9 9 9 9 9 9 9 9 9 9 9 9 9 9 9 9 
9 9 9 9 9 9 9 9 9 9 9 9 9 9 9 9 9 9 9 10 0 2 2 2 2 2 0 14 9 9 9 9 9 9 9 9 9 9 9 9 9 9 9 9 9 9 9 9 9 9 
9 9 9 9 9 9 9 9 9 9 9 9 9 9 9 9 9 9 9 10 2 2 2 2 2 2 2 14 9 9 9 9 9 9 9 9 9 9 9 9 9 9 9 9 9 9 9 9 9 9 
9 9 9 9 9 9 9 9 9 9 9 9 9 9 9 9 9 9 9 10 2 2 2 2 2 2 2 14 9 9 9 9 9 9 9 9 9 9 9 9 9 9 9 9 9 9 9 9 9 9 
9 9 9 9 9 9 9 9 9 9 9 9 9 9 9 9 9 9 9 10 2 2 2 2 2 2 2 14 9 9 9 9 9 9 9 9 9 9 9 9 9 9 9 9 9 9 9 9 9 9 
9 9 9 9 9 9 9 9 1 1 1 1 1 9 9 9 9 9 9 10 0 2 2 2 2 2 0 14 9 9 9 9 9 9 12 12 12 12 12 12 12 9 9 9 9 9 9 9 9 9 
9 9 9 9 9 9 9 9 1 3 3 3 1 9 9 9 9 9 9 10 0 0 0 5 0 0 0 14 9 9 9 9 9 10 5 5 5 5 5 5 5 13 9 9 9 9 9 9 9 9 
9 9 9 9 9 9 9 9 1 3 3 3 1 9 9 9 9 9 9 10 0 0 0 0 0 0 0 14 9 9 9 9 9 10 5 5 5 5 5 5 5 5 14 9 9 9 9 9 9 9 
9 9 9 9 9 9 9 9 1 3 3 3 1 9 9 9 9 9 9 9 7 7 8 0 15 7 7 9 9 9 9 9 9 10 5 5 5 5 5 5 5 5 14 9 9 9 9 9 9 9 
9 9 9 9 9 9 9 9 1 3 3 3 1 9 9 9 9 9 9 9 9 9 10 5 14 9 9 9 9 9 9 9 9 10 5 5 5 5 5 5 5 5 14 9 9 9 9 9 9 9 
9 9 9 9 9 9 9 9 1 1 5 1 1 9 9 9 9 9 9 9 9 9 10 5 14 9 9 9 9 9 9 9 9 10 5 5 5 5 5 5 5 5 14 9 9 9 9 9 9 9 
9 9 9 9 9 9 9 9 9 10 5 14 9 9 9 9 9 9 9 9 9 9 10 5 14 9 9 9 9 9 9 9 9 9 8 5 5 5 5 5 5 15 9 9 9 9 9 9 9 9 
9 9 9 9 9 9 9 9 9 10 5 14 9 9 9 9 9 9 9 9 9 9 10 5 14 9 9 9 9 9 9 9 9 9 9 7 8 5 5 15 7 9 9 9 9 9 9 9 9 9 
9 9 9 9 9 9 9 9 9 10 5 14 9 9 9 9 9 9 9 9 9 9 10 5 14 9 9 9 9 9 9 9 9 9 9 9 10 5 5 14 9 9 9 9 9 9 9 9 9 9 
9 9 9 9 9 9 9 9 12 11 5 14 9 9 9 9 9 9 9 9 9 9 10 5 14 9 9 9 9 9 9 9 9 9 9 9 10 5 5 14 9 9 9 9 9 9 9 9 9 9 
9 9 9 9 9 9 9 10 5 5 5 14 9 9 9 9 9 9 9 9 9 9 10 5 14 9 9 9 9 9 9 9 9 9 9 9 10 5 5 14 9 9 9 9 9 9 9 9 9 9 
9 9 9 9 9 9 9 10 5 15 7 9 9 9 9 9 9 9 9 9 9 9 11 5 13 9 9 9 9 9 9 9 9 9 9 9 11 5 5 14 9 9 9 9 9 9 9 9 9 9 
9 9 9 9 9 9 9 10 5 14 9 9 9 9 9 9 9 9 9 9 9 11 5 5 5 13 9 9 9 9 9 9 9 9 9 10 5 5 5 14 9 9 9 9 9 9 9 9 9 9 
9 9 9 9 9 9 9 10 5 14 9 9 9 9 9 9 9 9 9 9 11 5 5 5 5 5 13 9 9 9 9 9 9 9 9 11 5 5 15 9 9 9 9 9 9 9 9 9 9 9 
9 9 9 9 9 9 9 10 5 14 9 9 12 12 12 12 12 12 12 11 5 5 5 5 5 5 5 13 12 12 12 12 12 12 11 5 5 15 9 9 9 9 9 9 9 9 9 9 9 9 
9 9 9 9 9 9 9 10 5 14 9 10 5 5 5 5 5 5 5 5 5 5 5 5 5 5 5 5 5 5 5 5 5 5 5 5 5 14 9 9 9 9 9 9 9 9 9 9 9 9 
9 9 9 9 9 9 9 10 5 14 9 10 5 15 7 7 7 7 7 8 5 5 5 5 5 5 5 15 7 7 7 7 7 7 8 5 5 14 9 9 9 9 9 9 9 9 9 9 9 9 
9 9 9 9 9 9 9 10 5 14 9 10 5 14 9 9 9 9 9 9 8 5 5 5 5 5 15 9 9 9 9 9 9 9 10 5 5 14 9 9 9 9 9 9 9 9 9 9 9 9 
9 9 9 9 9 9 9 10 5 14 9 10 5 14 9 9 9 9 9 9 9 8 5 5 5 15 9 9 9 9 9 9 9 9 10 5 5 14 9 9 9 9 9 9 9 9 9 9 9 9 
9 9 9 9 9 9 9 10 5 14 9 11 5 13 12 9 9 9 9 9 9 9 8 5 15 9 9 9 9 9 9 9 9 9 10 5 5 14 9 9 9 9 9 9 9 9 9 9 9 9 
9 9 9 9 9 9 9 10 5 14 10 5 5 5 5 14 9 9 9 9 9 9 10 5 14 9 9 9 9 9 9 9 9 9 10 5 5 14 9 9 9 9 9 9 9 9 9 9 9 9 
9 9 9 9 9 9 9 10 5 14 10 5 5 5 5 14 9 9 9 9 9 9 10 5 14 9 9 9 9 9 9 9 9 9 9 8 5 14 9 9 9 9 9 9 9 9 9 9 9 9 
9 9 9 9 9 9 9 10 5 13 11 5 5 5 5 14 9 9 9 9 9 9 10 5 14 9 9 9 9 9 9 9 9 9 9 10 5 14 9 9 9 9 9 9 9 9 9 9 9 9 
9 9 9 9 9 9 9 10 5 5 5 5 5 5 5 14 9 9 9 9 9 9 10 5 14 9 9 9 9 9 9 9 9 9 9 10 5 14 9 9 9 9 9 9 9 9 9 9 9 9 
9 9 9 9 9 9 9 10 5 5 5 5 5 5 5 14 9 9 9 9 9 9 10 5 14 9 9 9 9 9 9 9 9 9 9 11 5 14 9 9 9 9 9 9 9 9 9 9 9 9 
9 9 9 9 9 9 9 10 5 5 5 5 5 5 5 14 9 9 9 9 9 9 10 5 14 9 9 9 9 9 9 9 9 9 10 5 5 5 14 9 9 9 9 9 9 9 9 9 9 9 
9 9 9 9 9 9 9 10 5 5 5 5 5 5 5 14 9 9 9 9 9 9 10 5 14 9 9 9 9 9 9 9 9 9 10 5 5 5 14 9 9 9 9 9 9 9 9 9 9 9 
9 9 9 9 9 9 9 10 5 5 5 5 5 5 5 14 9 9 9 9 9 9 10 5 14 9 9 9 9 9 9 9 9 9 10 5 5 5 14 9 9 9 9 9 9 9 9 9 9 9 
9 9 9 9 9 9 9 10 5 5 5 5 5 5 5 14 9 9 9 9 9 9 10 5 14 9 9 9 9 9 9 9 9 9 10 5 5 5 14 9 9 9 9 9 9 9 9 9 9 9 
9 9 9 9 9 9 9 9 7 7 7 7 7 7 7 9 9 9 9 12 12 12 11 5 13 12 12 9 9 9 9 9 9 9 11 5 5 5 14 9 9 9 9 9 9 9 9 9 9 9 
9 9 9 9 9 9 9 9 9 9 9 9 9 9 9 9 9 9 11 0 0 0 0 0 0 0 0 13 9 9 9 9 9 11 5 5 5 5 5 14 9 9 9 9 9 9 9 9 9 9 
9 9 9 9 9 9 9 9 9 9 9 9 9 9 9 9 9 10 0 0 0 0 0 0 0 0 0 0 14 9 0 9 11 0 0 0 0 0 0 14 9 9 9 9 9 9 9 9 9 9 
9 9 9 9 9 9 9 9 9 9 9 9 9 9 9 9 9 10 0 0 0 0 0 0 0 0 0 0 13 9 9 10 0 0 0 0 0 0 0 14 9 9 9 9 9 9 9 9 9 9 
9 9 9 9 9 9 9 9 9 9 9 9 9 0 9 9 9 10 0 0 0 0 0 0 0 0 0 0 0 13 12 11 0 0 0 0 0 9 0 14 9 9 9 9 9 9 9 9 9 9 
9 9 9 9 9 9 9 9 9 9 9 9 9 9 9 9 9 10 0 0 0 0 0 0 0 0 0 0 0 0 0 0 0 0 9 0 0 0 0 14 9 9 9 9 9 9 9 9 9 9 
9 9 9 9 9 9 9 9 9 9 9 9 9 0 9 9 9 9 8 0 0 0 0 0 0 0 0 15 7 7 8 0 0 0 0 0 0 0 0 14 9 9 9 9 9 9 9 9 9 9 
9 9 9 9 9 9 9 9 9 9 9 9 9 9 9 9 9 9 9 8 0 0 0 0 0 0 15 9 9 9 10 0 0 9 0 0 9 0 0 14 9 9 9 9 9 9 9 9 9 9 
9 9 9 9 9 9 9 9 9 9 9 9 9 9 9 9 9 9 9 9 7 7 7 7 7 7 9 9 9 9 9 8 0 0 0 0 0 0 15 9 9 9 9 9 9 9 9 9 9 9 
9 9 9 9 9 9 9 9 9 9 9 9 9 9 9 9 9 9 9 9 9 9 9 9 9 9 9 9 9 9 9 9 7 7 7 7 7 7 9 9 9 9 9 9 9 9 9 9 9 9 
9 9 9 9 9 9 9 9 9 9 9 9 9 9 9 9 9 9 9 9 9 9 9 9 9 9 9 9 9 9 9 9 9 9 9 9 9 9 9 9 9 9 9 9 9 9 9 9 9 9 
9 9 9 9 9 9 9 9 9 9 9 9 9 9 9 9 9 9 9 9 9 9 9 9 9 9 9 9 9 9 9 9 9 9 9 9 9 9 9 9 9 9 9 9 9 9 9 9 9 9 
9 9 9 9 9 9 9 9 9 9 9 9 9 9 9 9 9 9 9 9 9 9 9 9 9 9 9 9 9 9 9 9 9 9 9 9 9 9 9 9 9 9 9 9 9 9 9 9 9 9 
9 9 9 9 9 9 9 9 9 9 9 9 9 9 9 9 9 9 9 9 9 9 9 9 9 9 9 9 9 9 9 9 9 9 9 9 9 9 9 9 9 9 9 9 9 9 9 9 9 9 
9 9 9 9 9 9 9 9 9 9 9 9 9 9 9 9 9 9 9 9 9 9 9 9 9 9 9 9 9 9 9 9 9 9 9 9 9 9 9 9 9 9 9 9 9 9 9 9 9 9 